region_id,P_85ov_DNPCC,P_85ov_UCC_NS,P_85ov_Total,P_Tot_CF_Own_CCO,P_Tot_CF_Oth_CCO,P_Tot_CF_Own_CC_Oth_CC,P_Tot_CF_Total,P_Tot_DNPCC,P_Tot_UCC_NS,P_Tot_Total
POA6000,67,10,77,646,308,16,970,6377,1314,8661
POA6003,22,0,22,200,107,6,313,2082,346,2741
POA6004,53,11,67,560,296,12,868,5527,1308,7703
POA6005,80,17,100,301,183,6,490,3598,771,4859
POA6006,176,23,202,1324,432,69,1825,4782,547,7154
POA6007,156,20,176,840,321,48,1209,4118,560,5887
POA6008,169,73,242,1985,790,111,2886,7906,983,11775
POA6009,367,107,480,2591,992,132,3715,9116,806,13637
POA6010,410,118,538,2332,962,127,3421,8329,1013,12763
POA6011,150,81,231,1365,592,56,2013,4556,778,7347
POA6012,184,40,224,1271,482,50,1803,4748,569,7120
POA6014,481,61,547,3460,1004,205,4669,9577,892,15138
POA6015,160,29,192,1077,469,51,1597,3198,284,5079
POA6016,121,59,180,1677,370,98,2145,4852,741,7738
POA6017,49,7,60,446,179,8,633,2419,525,3577
POA6018,717,271,999,5779,2083,297,8159,17805,2103,28067
POA6019,252,61,313,2811,1203,140,4154,11311,1734,17199
POA6020,267,63,330,3225,1600,195,5020,10769,924,16713
POA6021,270,90,370,2876,1256,105,4237,10561,1140,15938
POA6022,50,9,59,786,365,60,1211,2676,185,4072
POA6023,228,31,264,2669,1077,176,3922,7683,456,12061
POA6024,180,23,203,2224,1105,138,3467,6950,512,10929
POA6025,241,55,302,5195,1987,291,7473,15211,1319,24003
POA6026,366,164,530,3877,1393,212,5482,11782,1011,18275
POA6027,345,82,433,6877,2695,356,9928,22335,2070,34333
POA6028,68,10,78,4159,1053,203,5415,9519,546,15480
POA6029,51,9,60,487,224,37,748,1223,142,2113
POA6030,375,59,440,7323,1950,379,9652,16103,2535,28290
POA6031,14,6,20,2631,515,128,3274,4368,498,8140
POA6032,0,0,0,40,13,0,53,117,15,185
POA6033,3,0,3,135,45,3,183,325,64,572
POA6035,20,90,110,789,213,36,1038,1855,404,3297
POA6036,13,3,16,2610,459,125,3194,3872,445,7511
POA6037,19,9,28,351,121,19,491,1099,177,1767
POA6041,9,0,9,175,76,3,254,735,104,1093
POA6042,0,0,0,7,0,0,7,57,10,74
POA6043,0,0,0,24,9,3,36,114,21,171
POA6044,16,3,19,162,67,11,240,759,236,1235
POA6050,477,114,595,1997,799,96,2892,8982,969,12843
POA6051,177,39,216,1529,500,73,2102,7620,1131,10853
POA6052,168,33,201,1651,531,88,2270,5780,563,8613
POA6053,347,72,423,2098,646,148,2892,7467,912,11271
POA6054,271,40,317,3107,1138,164,4409,10526,1150,16085
POA6055,139,19,158,2052,683,105,2840,5824,920,9584
POA6056,487,166,659,5639,2361,316,8316,18879,2880,30075
POA6057,89,22,114,2702,1021,159,3882,7928,961,12771
POA6058,156,21,177,1817,781,93,2691,6135,702,9528
POA6059,504,90,600,3405,1346,136,4887,12616,1257,18760
POA6060,484,128,615,2849,1106,87,4042,13287,1729,19058
POA6061,223,62,289,4783,1594,121,6498,17255,2980,26733
POA6062,528,79,614,4521,1994,159,6674,17590,1607,25871
POA6063,57,22,79,2454,714,98,3266,6717,841,10824
POA6064,231,56,287,4804,1696,171,6671,15414,1831,23916
POA6065,408,105,516,10875,2792,520,14187,23000,2148,39335
POA6066,71,13,87,3322,996,135,4453,9460,886,14799
POA6067,3,0,3,11,3,0,14,69,9,92
POA6068,0,0,0,0,0,0,0,0,0,0
POA6069,131,22,153,5770,1275,250,7295,9936,1010,18241
POA6070,34,0,34,626,259,48,933,1730,133,2796
POA6071,31,3,34,584,258,32,874,1714,237,2825
POA6072,10,3,13,124,55,6,185,432,80,697
POA6073,50,44,94,457,228,29,714,1560,221,2495
POA6074,9,6,15,165,84,8,257,486,36,779
POA6076,349,109,462,3257,1721,226,5204,11230,1112,17546
POA6077,20,3,23,198,105,4,307,883,95,1285
POA6078,3,0,3,139,65,3,207,441,41,689
POA6079,0,0,0,0,0,0,0,4,0,4
POA6081,22,0,22,924,274,63,1261,2154,185,3600
POA6082,11,0,11,558,199,35,792,1464,215,2471
POA6083,10,0,13,534,182,44,760,1791,239,2790
POA6084,26,3,32,1192,341,44,1577,3001,363,4941
POA6090,0,0,0,0,0,0,0,13,0,13
POA6100,121,29,156,1675,649,72,2396,8305,1288,11989
POA6101,231,54,288,2130,605,93,2828,8779,1085,12692
POA6102,521,282,806,1255,432,39,1726,8891,1661,12278
POA6103,101,39,140,1094,309,17,1420,4957,824,7201
POA6104,228,37,265,1852,686,64,2602,7269,1232,11103
POA6105,216,54,270,1992,699,96,2787,7322,980,11089
POA6106,0,0,0,3,0,0,3,12,3,18
POA6107,314,81,395,5570,1836,215,7621,19745,2691,30057
POA6108,151,21,172,3629,1572,189,5390,11825,1164,18379
POA6109,127,26,159,1551,589,69,2209,5467,898,8574
POA6110,332,179,511,5909,2016,336,8261,16577,2481,27319
POA6111,227,34,267,3392,1495,226,5113,11284,1366,17763
POA6112,294,98,395,6956,2310,422,9688,18938,2546,31172
POA6121,14,0,14,528,223,26,777,1219,124,2120
POA6122,67,10,77,1855,559,97,2511,4135,385,7031
POA6123,6,3,9,288,68,17,373,641,56,1070
POA6124,3,3,6,189,58,6,253,516,68,837
POA6125,16,6,22,470,160,19,649,1303,147,2099
POA6126,3,0,3,28,15,3,46,162,248,456
POA6147,126,27,156,2276,851,96,3223,8080,720,12023
POA6148,405,78,489,2655,1184,115,3954,9494,919,14367
POA6149,318,127,448,2866,1170,180,4216,10632,694,15542
POA6150,239,55,298,1795,758,87,2640,8062,512,11214
POA6151,267,55,325,2209,859,156,3224,9549,1205,13978
POA6152,618,162,783,2945,1348,149,4442,14937,1586,20965
POA6153,368,97,468,2809,1328,124,4261,10556,1213,16030
POA6154,375,51,434,1551,573,82,2206,5204,524,7934
POA6155,284,36,330,8803,2715,364,11882,23467,2546,37895
POA6156,327,56,389,2740,964,152,3856,8084,823,12763
POA6157,344,79,426,2044,774,118,2936,7114,744,10794
POA6158,138,19,157,1231,472,67,1770,3484,376,5630
POA6159,63,0,63,344,219,19,582,1555,239,2376
POA6160,116,24,147,840,440,59,1339,4892,631,6862
POA6161,0,0,0,5,3,7,15,78,6,99
POA6162,179,37,216,1559,630,134,2323,5644,657,8624
POA6163,710,194,912,6752,2889,374,10015,25823,2609,38447
POA6164,187,20,212,9888,2402,450,12740,21185,2136,36061
POA6165,0,0,0,12,6,3,21,58,21,100
POA6166,63,15,78,1321,586,54,1961,4342,443,6746
POA6167,185,60,245,3867,1174,195,5236,9896,2375,17507
POA6168,462,121,583,3061,1475,163,4699,13113,1840,19652
POA6169,388,74,467,5624,2230,297,8151,16991,2153,27295
POA6170,10,3,13,1267,436,72,1775,2736,408,4919
POA6171,23,3,31,3665,820,228,4713,6195,579,11487
POA6172,66,47,113,2779,759,186,3724,5576,981,10281
POA6173,9,0,9,2649,495,135,3279,3695,334,7308
POA6174,5,0,5,395,125,23,543,957,154,1654
POA6175,8,0,8,667,177,40,884,1169,130,2183
POA6176,0,0,0,135,50,3,188,351,26,565
POA6180,0,6,6,704,186,30,920,1446,210,2576
POA6181,0,0,0,95,31,4,130,228,36,394
POA6182,0,0,0,0,0,0,0,0,0,0
POA6207,4,0,7,166,47,12,225,539,87,851
POA6208,101,30,131,1428,560,92,2080,4922,672,7674
POA6209,23,14,37,241,113,11,365,1030,158,1553
POA6210,1065,445,1518,8588,3696,516,12800,32315,4751,49866
POA6211,19,5,24,974,361,47,1382,2627,303,4312
POA6213,0,0,0,114,54,5,173,345,39,557
POA6214,0,0,0,72,30,0,102,157,17,276
POA6215,50,8,58,572,196,42,810,1849,189,2848
POA6218,3,0,3,67,26,0,93,209,60,362
POA6220,55,18,73,716,278,43,1037,2431,369,3837
POA6221,3,0,3,87,15,4,106,203,31,340
POA6224,12,3,15,191,82,13,286,542,92,920
POA6225,122,21,143,1494,590,75,2159,4571,631,7361
POA6226,3,3,6,120,54,4,178,276,27,481
POA6227,0,0,3,115,20,8,143,195,32,370
POA6229,3,3,6,89,36,3,128,234,41,403
POA6230,530,158,698,6623,2289,339,9251,20044,3048,32343
POA6232,152,26,178,1810,577,106,2493,4340,453,7286
POA6233,82,21,103,3082,910,168,4160,6941,853,11954
POA6236,8,8,16,362,113,26,501,902,87,1490
POA6237,15,3,18,425,145,25,595,1277,130,2002
POA6239,47,11,58,653,226,29,908,2128,199,3235
POA6240,0,0,0,49,17,0,66,137,8,211
POA6244,31,4,35,292,78,12,382,797,72,1251
POA6251,0,0,0,67,27,0,94,225,32,351
POA6253,9,0,9,67,45,0,112,339,31,482
POA6254,7,0,7,98,26,0,124,347,34,505
POA6255,48,6,54,564,198,32,794,1840,121,2755
POA6256,3,0,3,35,9,0,44,112,9,165
POA6258,94,26,123,1013,317,54,1384,3193,342,4919
POA6260,19,5,24,278,94,17,389,738,67,1194
POA6262,0,0,0,114,40,6,160,412,56,628
POA6271,10,3,16,470,143,32,645,1281,225,2151
POA6275,11,3,14,166,74,14,254,740,69,1063
POA6280,444,81,528,3998,1319,192,5509,11602,1365,18476
POA6281,42,10,52,1091,334,60,1485,2539,268,4292
POA6282,3,3,6,249,77,18,344,573,55,972
POA6284,7,3,10,357,71,22,450,645,110,1205
POA6285,74,16,90,1483,359,104,1946,3314,529,5789
POA6286,5,0,5,76,35,6,117,330,56,503
POA6288,6,0,6,51,29,3,83,224,43,350
POA6290,60,18,78,186,113,13,312,1016,115,1443
POA6302,36,12,48,483,233,35,751,1796,229,2776
POA6304,30,6,36,181,64,9,254,932,104,1290
POA6306,30,6,36,142,51,3,196,484,68,748
POA6308,26,6,32,265,102,12,379,779,96,1254
POA6309,3,0,3,54,6,3,63,144,12,219
POA6311,4,0,4,111,28,9,148,296,27,471
POA6312,98,16,114,748,297,68,1113,2411,272,3796
POA6313,0,0,0,66,32,3,101,185,13,299
POA6315,40,12,52,291,101,12,404,959,101,1464
POA6316,3,0,3,85,17,7,109,174,22,305
POA6317,39,25,64,694,199,33,926,1976,259,3161
POA6318,0,0,0,39,9,0,48,122,8,178
POA6320,11,3,14,169,42,12,223,372,57,652
POA6321,0,4,4,30,7,6,43,140,19,202
POA6322,4,6,10,69,31,5,105,226,41,372
POA6323,7,3,10,158,45,6,209,517,47,773
POA6324,63,10,73,498,127,23,648,1591,180,2419
POA6326,4,0,4,79,27,0,106,283,32,421
POA6327,3,0,3,55,24,4,83,154,7,244
POA6328,0,0,0,64,22,6,92,228,25,345
POA6330,616,128,747,5296,1878,337,7511,16794,2026,26331
POA6333,83,19,102,818,248,82,1148,2791,257,4196
POA6335,11,3,14,145,64,17,226,339,39,604
POA6336,0,0,0,41,19,3,63,112,16,191
POA6337,0,0,0,87,38,5,130,221,18,369
POA6338,0,0,0,149,29,9,187,345,49,581
POA6341,0,0,0,54,16,0,70,139,8,217
POA6343,0,0,0,59,18,0,77,96,3,176
POA6346,3,0,3,115,26,10,151,406,31,588
POA6348,3,4,7,249,43,13,305,646,112,1063
POA6350,7,0,7,25,10,3,38,122,15,175
POA6352,0,0,0,86,29,9,124,179,6,309
POA6353,11,0,11,134,30,11,175,365,26,566
POA6355,0,3,3,185,43,0,228,392,37,657
POA6358,3,3,6,38,23,0,61,124,12,197
POA6359,4,0,4,102,33,12,147,231,62,440
POA6365,11,0,11,112,50,6,168,277,15,460
POA6367,6,0,6,49,22,0,71,127,14,212
POA6368,0,0,0,34,13,0,47,95,6,148
POA6369,15,11,29,89,32,4,125,346,40,511
POA6370,6,3,9,99,25,3,127,276,28,431
POA6373,0,0,0,47,6,3,56,122,6,184
POA6375,29,5,34,104,65,10,179,452,59,690
POA6383,25,3,28,161,38,0,199,595,44,838
POA6386,0,0,0,56,9,6,71,106,3,180
POA6390,15,3,18,374,93,34,501,959,389,1849
POA6391,6,0,6,157,64,14,235,457,37,729
POA6392,8,0,8,97,24,9,130,227,25,382
POA6393,4,0,4,74,22,0,96,190,14,300
POA6394,0,0,0,81,26,4,111,195,15,321
POA6395,29,3,32,274,121,13,408,752,76,1236
POA6396,0,0,0,67,10,4,81,167,29,277
POA6397,6,0,6,50,15,0,65,149,98,312
POA6398,6,0,6,77,28,8,113,302,37,452
POA6401,137,24,167,1066,420,65,1551,3686,700,5937
POA6403,0,0,0,35,15,0,50,99,3,152
POA6405,0,3,3,41,6,0,47,154,12,213
POA6407,21,8,29,148,53,8,209,579,58,846
POA6409,4,0,4,80,28,4,112,155,27,294
POA6410,31,3,34,178,67,6,251,603,67,921
POA6413,3,0,3,25,7,0,32,92,0,124
POA6415,30,8,38,454,126,23,603,1500,169,2272
POA6418,15,9,24,109,50,12,171,341,50,562
POA6421,0,0,0,53,9,0,62,109,6,177
POA6423,3,0,3,50,9,0,59,153,18,230
POA6425,4,0,4,24,4,0,28,97,4,129
POA6426,7,0,7,204,35,10,249,508,79,836
POA6429,0,0,0,192,67,0,259,779,218,1256
POA6430,113,23,136,3955,1018,227,5200,10157,2217,17574
POA6431,0,0,3,71,105,9,185,279,47,511
POA6432,13,13,26,1203,305,89,1597,3278,1055,5930
POA6434,0,0,0,32,0,0,32,72,3,107
POA6436,0,0,0,18,3,0,21,101,21,143
POA6437,0,0,3,244,38,3,285,583,198,1066
POA6438,8,0,8,93,51,7,151,490,399,1040
POA6440,0,0,0,145,71,11,227,613,126,966
POA6442,4,0,4,565,99,33,697,1001,240,1938
POA6443,6,3,9,155,41,10,206,550,170,926
POA6445,0,0,0,40,4,0,44,72,3,119
POA6447,3,0,3,100,22,9,131,174,37,342
POA6448,4,0,4,71,17,0,88,219,58,365
POA6450,142,40,182,2074,656,107,2837,5915,913,9665
POA6460,14,3,17,177,58,5,240,470,47,757
POA6461,8,9,17,58,27,4,89,176,24,289
POA6462,6,0,6,65,21,0,86,139,6,231
POA6468,0,3,3,39,17,6,62,96,8,166
POA6472,0,0,0,35,3,6,44,95,3,142
POA6475,4,0,4,75,24,3,102,216,15,333
POA6477,4,0,4,55,5,3,63,161,4,228
POA6479,4,0,4,68,34,8,110,267,22,399
POA6484,0,0,0,47,15,0,62,217,88,367
POA6485,17,0,17,75,13,6,94,285,44,423
POA6488,6,0,6,57,6,7,70,187,22,279
POA6490,3,0,3,28,10,3,41,125,12,178
POA6501,3,0,3,183,69,7,259,482,48,789
POA6502,8,6,14,150,44,3,197,583,87,867
POA6503,15,9,24,341,116,16,473,962,158,1593
POA6505,0,0,0,43,12,0,55,156,24,235
POA6507,4,0,4,65,27,4,96,226,9,331
POA6509,3,0,3,60,17,0,77,171,9,257
POA6510,34,8,42,342,113,16,471,1020,113,1604
POA6511,3,0,3,58,35,3,96,253,39,388
POA6513,0,0,0,47,15,6,68,63,8,139
POA6514,0,0,0,56,36,12,104,368,48,520
POA6515,6,0,6,76,19,3,98,252,7,357
POA6516,13,6,19,254,50,12,316,749,114,1179
POA6517,3,3,6,74,31,3,108,205,31,344
POA6518,0,0,0,9,4,0,13,61,15,89
POA6519,9,3,12,111,21,7,139,285,44,468
POA6521,4,0,4,62,17,3,82,183,9,274
POA6522,4,0,4,89,14,3,106,233,23,362
POA6525,40,9,49,569,159,24,752,1834,225,2811
POA6528,3,0,3,39,24,0,63,144,26,233
POA6530,364,89,461,5216,1890,324,7430,15301,2022,24753
POA6532,19,6,28,1018,269,52,1339,2656,563,4558
POA6535,23,11,34,200,73,4,277,845,114,1236
POA6536,9,5,14,230,70,11,311,782,104,1197
POA6537,8,0,8,90,23,11,124,378,39,541
POA6556,14,0,14,303,126,32,461,933,82,1476
POA6558,5,0,5,130,43,0,173,394,1440,2007
POA6560,8,0,8,193,68,8,269,614,111,994
POA6562,3,0,3,172,75,13,260,577,67,904
POA6564,3,0,3,45,20,10,75,186,19,280
POA6566,23,11,34,415,172,27,614,1662,242,2518
POA6567,0,4,4,57,19,3,79,198,26,303
POA6568,3,0,3,53,6,0,59,112,11,182
POA6569,0,6,6,63,14,6,83,152,25,260
POA6575,0,0,0,49,20,0,69,115,0,184
POA6603,18,3,21,204,60,16,280,515,52,847
POA6606,0,0,0,65,9,0,74,153,15,242
POA6608,0,3,3,47,12,0,59,130,18,207
POA6609,12,3,15,82,44,7,133,305,22,460
POA6612,0,0,0,37,9,0,46,127,15,188
POA6620,0,0,0,33,9,4,46,80,9,135
POA6623,14,3,17,264,64,15,343,841,132,1316
POA6628,0,0,0,39,12,3,54,71,3,128
POA6630,4,0,4,67,21,0,88,261,76,425
POA6635,0,0,0,78,23,0,101,266,72,439
POA6638,0,0,0,55,15,4,74,367,76,517
POA6639,0,0,0,7,0,0,7,66,21,94
POA6640,5,0,5,18,3,0,21,144,58,223
POA6642,8,0,8,154,82,10,246,638,240,1124
POA6646,0,0,0,183,66,14,263,625,144,1032
POA6701,36,11,47,811,275,40,1126,2670,684,4480
POA6705,0,0,0,40,11,0,51,105,27,183
POA6707,8,0,8,400,99,29,528,1209,181,1918
POA6710,0,0,0,246,84,12,342,1378,480,2200
POA6713,3,0,3,240,50,6,296,533,168,997
POA6714,6,3,9,2812,503,147,3462,7734,3377,14573
POA6716,0,0,0,156,22,12,190,249,29,468
POA6718,6,0,6,93,62,9,164,326,158,648
POA6720,0,0,0,378,87,28,493,964,525,1982
POA6721,3,3,6,732,143,47,922,2407,1020,4349
POA6722,17,6,23,1512,360,71,1943,4444,1811,8198
POA6725,16,13,29,1511,541,133,2185,4163,1108,7456
POA6726,10,3,13,774,232,67,1073,2361,491,3925
POA6728,21,3,24,748,368,88,1204,2118,2039,5361
POA6740,7,4,11,241,124,22,387,698,158,1243
POA6743,11,0,11,893,334,93,1320,2975,579,4874
POA6751,0,0,0,1144,202,48,1394,2280,790,4464
POA6753,0,4,4,1438,335,97,1870,3997,1745,7612
POA6754,3,0,3,337,34,6,377,604,106,1087
POA6758,0,0,0,21,19,0,40,76,9,125
POA6760,0,0,0,66,76,12,154,163,40,357
POA6762,0,0,0,169,96,42,307,656,127,1090
POA6765,3,4,7,220,133,30,383,637,104,1124
POA6770,8,6,14,402,339,109,850,1244,174,2268
POA6907,0,0,0,6,30,0,36,893,37,966
